Video Game Menace
An Interactive Fiction by Martin Brown
Release 1 / Serial number 240316 / Inform 7 v10.1.2 / D

Rocket base
The Rocket base is a big, circular room. There is a launch pad in the center of the room. It looks like a rocket was once here but someone has taken it apart and hidden the pieces. There are exits to the North, South, and West.

You can see the launch pad here.

I beg your pardon?

* * *

Video Game Menace
An Interactive Fiction by Martin Brown
Release 1 / Serial number 240316 / Inform 7 v10.1.2 / D

Rocket base
The Rocket base is a big, circular room. There is a launch pad in the center of the room. It looks like a rocket was once here but someone has taken it apart and hidden the pieces. There are exits to the North, South, and West.

You can see the launch pad here.

>N
Are you sure you want to quit?

* * *

>n
Are you sure you want to quit?

* * *

Video Game Menace
An Interactive Fiction by Martin Brown
Release 1 / Serial number 240316 / Inform 7 v10.1.2 / D

Rocket base
The Rocket base is a big, circular room. There is a launch pad in the center of the room. It looks like a rocket was once here but someone has taken it apart and hidden the pieces. There are exits to the North, South, and West.

You can see the launch pad here.

>a
Save failed.

* * *

Video Game Menace
An Interactive Fiction by Martin Brown
Release 1 / Serial number 240316 / Inform 7 v10.1.2 / D

Rocket base
The Rocket base is a big, circular room. There is a launch pad in the center of the room. It looks like a rocket was once here but someone has taken it apart and hidden the pieces. There are exits to the North, South, and West.

You can see the launch pad here.

>e
You can't go that way.

I don't understand that command.

WASD

>s
You can't go that way.

You can't go that way.

WASD

>w
You can't go that way.

You can't go that way.

WASD

>a
That's not a verb I recognise.

WASD

* * *

>e
You can't go that way.

I don't understand that command.

WASD

>w
store cupbard
A small room used for storing things. There is a shelf against one wall.

A nose cone of a rocket.

You can see a shelf here.

>take nose cone
Taken.

>wear nose cone
You put on the nose cone.

* * *

Video Game Menace
An Interactive Fiction by Martin Brown
Release 1 / Serial number 240316 / Inform 7 v10.1.2 / D

Rocket base
The Rocket base is a big, circular room. There is a launch pad in the center of the room. It looks like a rocket was once here but someone has taken it apart and hidden the pieces. There are exits to the North, South, and West.

You can see the launch pad here.

>n
control room
You can see a big television here.

>s
Rocket base
The Rocket base is a big, circular room. There is a launch pad in the center of the room. It looks like a rocket was once here but someone has taken it apart and hidden the pieces. There are exits to the North, South, and West.

You can see the launch pad here.

* * *

Video Game Menace
An Interactive Fiction by Martin Brown
Release 1 / Serial number 240316 / Inform 7 v10.1.2 / D

Rocket base
The Rocket base is a big, circular room. There is a launch pad in the center of the room. It looks like a rocket was once here but someone has taken it apart and hidden the pieces. There are exits to the North, South, and West.

You can see the launch pad here.

>north
control room
You can see a big television here.

* * *

Video Game Menace
An Interactive Fiction by Martin Brown
Release 1 / Serial number 240316 / Inform 7 v10.1.2 / D

Rocket base
The Rocket base is a big, circular room. There is a launch pad in the center of the room. It looks like a rocket was once here but someone has taken it apart and hidden the pieces. There are exits to the North, South, and West.

You can see the launch pad here.

>save
Save failed.

>save
That's not a verb I recognise.

* * *

Video Game Menace
An Interactive Fiction by Martin Brown
Release 1 / Serial number 240316 / Inform 7 v10.1.2 / D

Rocket base
The Rocket base is a big, circular room. There is a launch pad in the center of the room. It looks like a rocket was once here but someone has taken it apart and hidden the pieces. There are exits to the North, South, and West.

You can see the launch pad here.

>take all
That's not a verb I recognise.

>e
You can't go that way.

>w
storage cupboard
A small room used for storing things. There is a shelf against one wall.

A nose cone of a rocket.

You can see a shelf here.

>take all
That's not a verb I recognise.

>take nose cone
That's not a verb I recognise.

* * *

Video Game Menace
An Interactive Fiction by Martin Brown
Release 1 / Serial number 240316 / Inform 7 v10.1.2 / D

Rocket base
The Rocket base is a big, circular room. There is a launch pad in the center of the room. It looks like a rocket was once here but someone has taken it apart and hidden the pieces. There are exits to the North, South, and West.

You can see the launch pad here.

>w
control room
You can see a big television here.

>climb shelf
You climb up the shelf and discover Easter egg 2!
You found another Easter egg while climbing the shelf!

[Your score has just gone up by ten points.]

>climb shelf
You already looked and there is nothing interesting there.

* * *

>climb shelf
You climb up the shelf and discover Easter egg 2!
You found another Easter egg while climbing the shelf!

[Your score has just gone up by ten points.]

>i
You are carrying:
  Easter egg 2

* * *

>w
control room
You can see a big television here.

>e
Rocket base
The Rocket base is a big, circular room. There is a launch pad in the center of the room. It looks like a rocket was once here but someone has taken it apart and hidden the pieces. There are exits to the North, South, and West.

You can see the launch pad here.

>assemble rocket
You do not have all the necessary parts to assemble the rocket.

You do not have all the necessary parts to assemble the rocket.

>w
storage cupboard
A small room used for storing things. There is a shelf against one wall.

A nose cone of a rocket.

You can see a shelf here.

>take all
nose cone: Taken.

>w
You can't go that way.

>e
Rocket base
The Rocket base is a big, circular room. There is a launch pad in the center of the room. It looks like a rocket was once here but someone has taken it apart and hidden the pieces. There are exits to the North, South, and West.

You can see the launch pad here.

>s
bathroom
A bathroom with a white rug.

You can see a rug here.

>look udner rug
You can't see any such thing.

>look under rug
Under the rug, you find a rocket body, which you retrieve.

[Your score has just gone up by ten points.]

>n
Rocket base
The Rocket base is a big, circular room. There is a launch pad in the center of the room. It looks like a rocket was once here but someone has taken it apart and hidden the pieces. There are exits to the North, South, and West.

You can see the launch pad here.

>assemble rocket
Yes, that looks right!

Yes, that looks right!

    *** You click the rocket pieces together and escape! But maybe you should have remembered the extra fuel... ***

In that game you scored 50 out of a possible 50, in 11 turns.

Would you like to RESTART, RESTORE a saved game, QUIT or UNDO the last command?

* * *

>e
Rocket base
The Rocket base is a big, circular room. There is a launch pad in the center of the room. It looks like a rocket was once here but someone has taken it apart and hidden the pieces. There are exits to the North, South, and West.

You can see the launch pad here.

>e
You can't go that way.

I don't understand that command.

WASD

>w
storage cupboard
A small room used for storing things. There is a shelf against one wall.

A nose cone of a rocket.

You can see a shelf here.

You can't go that way.

WASD

>s
You can't go that way.

You can't go that way.

WASD

>e
Rocket base
The Rocket base is a big, circular room. There is a launch pad in the center of the room. It looks like a rocket was once here but someone has taken it apart and hidden the pieces. There are exits to the North, South, and West.

You can see the launch pad here.

I don't understand that command.

WASD

>d
You can't go that way.

You can't go that way.

WASD

>a
That's not a verb I recognise.

WASD

>A
That's not a verb I recognise.

WASD

>a
That's not a verb I recognise.

WASD

>s
bathroom
A bathroom with a white rug.

You can see a rug here.

You can't go that way.

WASD

>w
You can't go that way.

Rocket base
The Rocket base is a big, circular room. There is a launch pad in the center of the room. It looks like a rocket was once here but someone has taken it apart and hidden the pieces. There are exits to the North, South, and West.

You can see the launch pad here.

WASD

>w
storage cupboard
A small room used for storing things. There is a shelf against one wall.

A nose cone of a rocket.

You can see a shelf here.

You can't go that way.

WASD

>d
You can't go that way.

Rocket base
The Rocket base is a big, circular room. There is a launch pad in the center of the room. It looks like a rocket was once here but someone has taken it apart and hidden the pieces. There are exits to the North, South, and West.

You can see the launch pad here.

WASD

>s
bathroom
A bathroom with a white rug.

You can see a rug here.

You can't go that way.

WASD

* * *

>w
You can't go that way.

Rocket base
The Rocket base is a big, circular room. There is a launch pad in the center of the room. It looks like a rocket was once here but someone has taken it apart and hidden the pieces. There are exits to the North, South, and West.

You can see the launch pad here.

WASD

>a
That's not a verb I recognise.

WASD

>a
That's not a verb I recognise.

WASD

>l
Rocket base
The Rocket base is a big, circular room. There is a launch pad in the center of the room. It looks like a rocket was once here but someone has taken it apart and hidden the pieces. There are exits to the North, South, and West.

You can see the launch pad here.

I don't understand that command.

WASD

>l
Rocket base
The Rocket base is a big, circular room. There is a launch pad in the center of the room. It looks like a rocket was once here but someone has taken it apart and hidden the pieces. There are exits to the North, South, and West.

You can see the launch pad here.

I don't understand that command.

WASD

>w
storage cupboard
A small room used for storing things. There is a shelf against one wall.

A nose cone of a rocket.

You can see a shelf here.

You can't go that way.

WASD

>e
Rocket base
The Rocket base is a big, circular room. There is a launch pad in the center of the room. It looks like a rocket was once here but someone has taken it apart and hidden the pieces. There are exits to the North, South, and West.

You can see the launch pad here.

I don't understand that command.

WASD

>s
bathroom
A bathroom with a white rug.

You can see a rug here.

You can't go that way.

WASD

* * *

>w
You can't go that way.

Rocket base
The Rocket base is a big, circular room. There is a launch pad in the center of the room. It looks like a rocket was once here but someone has taken it apart and hidden the pieces. There are exits to the North, South, and West.

You can see the launch pad here.

WASD

>s
bathroom
A bathroom with a white rug.

You can see a rug here.

You can't go that way.

WASD

* * *

>e
Rocket base
The Rocket base is a big, circular room. There is a launch pad in the center of the room. It looks like a rocket was once here but someone has taken it apart and hidden the pieces. There are exits to the North, South, and West.

You can see the launch pad here.

>n
control room
You can see a big television here.

I don't understand that command.

WASD

* * *

>e
Rocket base
The Rocket base is a big, circular room. There is a launch pad in the center of the room. It looks like a rocket was once here but someone has taken it apart and hidden the pieces. There are exits to the North, South, and West.

You can see the launch pad here.

>q
Are you sure you want to quit?

* * *

>version
Video Game Menace
An Interactive Fiction by Martin Brown
Release 1 / Serial number 240316 / Inform 7 v10.1.2 / D
Inform 7 v10.1.2
Identification number: //55429815-2632-4003-9759-51D1B99ACAF0//
Interpreter version 0.6.0 / VM 3.1.3

* * *

>w
control room
You can see a big television here.

>l
storage cupboard
A small room used for storing things. There is a shelf against one wall.

>take rocket cone
You can't see any such thing.

>take nose cone
You can't see any such thing.

* * *

>w
control room
You can see a big television here.

>look at shelf
You can't see any such thing.

>take all
You can't see any such thing.

* * *

>w
control room
You can see a big television here.

>s
Rocket base
The Rocket base is a big, circular room. There is a launch pad in the center of the room. It looks like a rocket was once here but someone has taken it apart and hidden the pieces. There are exits to the North, South, and West.

You can see the launch pad here.

>climb shelf
Little is to be achieved by that.

>climb shelf
Little is to be achieved by that.

* * *

>s
Rocket base
The Rocket base is a big, circular room. There is a launch pad in the center of the room. It looks like a rocket was once here but someone has taken it apart and hidden the pieces. There are exits to the North, South, and West.

You can see the launch pad here.

>e
Rocket base
The Rocket base is a big, circular room. There is a launch pad in the center of the room. It looks like a rocket was once here but someone has taken it apart and hidden the pieces. There are exits to the North, South, and West.

You can see the launch pad here.

* * *

>s
bathroom
A bathroom with a white rug.

You can see a rug here.

>w
You can't go that way.

>n
Rocket base
The Rocket base is a big, circular room. There is a launch pad in the center of the room. It looks like a rocket was once here but someone has taken it apart and hidden the pieces. There are exits to the North, South, and West.

You can see the launch pad here.

>n
control room
You can see a big television here.

* * *

>s
Rocket base
The Rocket base is a big, circular room. There is a launch pad in the center of the room. It looks like a rocket was once here but someone has taken it apart and hidden the pieces. There are exits to the North, South, and West.

You can see the launch pad here.

>s
bathroom
A bathroom with a white rug.

You can see a rug here.

>w
Rocket base
The Rocket base is a big, circular room. There is a launch pad in the center of the room. It looks like a rocket was once here but someone has taken it apart and hidden the pieces. There are exits to the North, South, and West.

You can see the launch pad here.

>a
storage cupboard
A small room used for storing things. There is a shelf against one wall.

A nose cone of a rocket.

You can see a shelf here.

>d
Rocket base
The Rocket base is a big, circular room. There is a launch pad in the center of the room. It looks like a rocket was once here but someone has taken it apart and hidden the pieces. There are exits to the North, South, and West.

You can see the launch pad here.

>a
storage cupboard
A small room used for storing things. There is a shelf against one wall.

A nose cone of a rocket.

You can see a shelf here.

* * *

>d
Rocket base
The Rocket base is a big, circular room. There is a launch pad in the center of the room. It looks like a rocket was once here but someone has taken it apart and hidden the pieces. There are exits to the North, South, and West.

You can see the launch pad here.

>w
control room
You can see a big television here.

* * *

>s
Rocket base
The Rocket base is a big, circular room. There is a launch pad in the center of the room. It looks like a rocket was once here but someone has taken it apart and hidden the pieces. There are exits to the North, South, and West.

You can see the launch pad here.

>a
storage cupboard
A small room used for storing things. There is a shelf against one wall.

A nose cone of a rocket.

You can see a shelf here.

* * *

>w
control room
You can see a big television here.

>take all
nose cone: Taken.

I beg your pardon?

>e
Rocket base
The Rocket base is a big, circular room. There is a launch pad in the center of the room. It looks like a rocket was once here but someone has taken it apart and hidden the pieces. There are exits to the North, South, and West.

You can see the launch pad here.

* * *

>s
bathroom
A bathroom with a white rug.

You can see a rug here.

>look under rug
Under the rug, you find a rocket body, which you retrieve.

[Your score has just gone up by ten points.]

>w
You can't go that way.

* * *

>n
Rocket base
The Rocket base is a big, circular room. There is a launch pad in the center of the room. It looks like a rocket was once here but someone has taken it apart and hidden the pieces. There are exits to the North, South, and West.

You can see the launch pad here.

>assemble rocket
Yes, that looks right!

Yes, that looks right!

That's not a verb I recognise.

* * *

>take all
nose cone: Taken.

>climb shelf
You climb up the shelf and discover Easter egg 2!
You found another Easter egg while climbing the shelf!

[Your score has just gone up by ten points.]

>wear nose cone
You found an Easter egg, well done!

You put on the nose cone.

[Your score has just gone up by ten points.]

>e
Rocket base
The Rocket base is a big, circular room. There is a launch pad in the center of the room. It looks like a rocket was once here but someone has taken it apart and hidden the pieces. There are exits to the North, South, and West.

You can see the launch pad here.

>n
control room
You can see a big television here.

* * *

>s
bathroom
A bathroom with a white rug.

You can see a rug here.

>take rug
The rug is taped to the ground except for a little hole that your hand can fit through.

>look under rug
Under the rug, you find a rocket body, which you retrieve.

[Your score has just gone up by ten points.]

* * *

>n
Rocket base
The Rocket base is a big, circular room. There is a launch pad in the center of the room. It looks like a rocket was once here but someone has taken it apart and hidden the pieces. There are exits to the North, South, and West.

You can see the launch pad here.

>put nose cone on launch pad
(first taking it off)
Yes, that looks right!

[Your score has just gone up by ten points.]

>put body on launch pad
Yes, that looks right!

    *** You click the rocket pieces together and escape! But maybe you should have remembered the extra fuel... ***

In that game you scored 50 out of a possible 50, in 14 turns.

Would you like to RESTART, RESTORE a saved game, QUIT or UNDO the last command?

* * *

>take all
nose cone: Taken.

>e
Rocket base
The Rocket base is a big, circular room. There is a launch pad in the center of the room. It looks like a rocket was once here but someone has taken it apart and hidden the pieces. There are exits to the North, South, and West.

You can see the launch pad here.

* * *

>n
Rocket base
The Rocket base is a big, circular room. There is a launch pad in the center of the room. It looks like a rocket was once here but someone has taken it apart and hidden the pieces. There are exits to the North, South, and West.

You can see the launch pad here.

>build rocket
Yes, that looks right!

Yes, that looks right!

    *** You click the rocket pieces together and escape! But maybe you should have remembered the extra fuel... ***

In that game you scored 50 out of a possible 50, in 7 turns.

Would you like to RESTART, RESTORE a saved game, QUIT or UNDO the last command?

* * *

>take all
nose cone: Taken.

>put on nose cone
you found a easter egg, well done!

You put on the nose cone.

[Your score has just gone up by ten points.]

>i
You are carrying:
  a nose cone (being worn)

>i
You are carrying:
  a nose cone (being worn)

>easter egg 1
That's not a verb I recognise.

>put Easter egg 1 on shelf
You can't see any such thing.

* * *

>s
bathroom
A bathroom with a white rug.

You can see a rug here.

>take alll
You can't see any such thing.

>take all
rug: The rug is taped to the ground except for a little hole that your hand can fit through.

>look under rug
Under the rug, you find a rocket body, which you retrieve.

[Your score has just gone up by ten points.]

* * *

>n
Rocket base
The Rocket base is a big, circular room. There is a launch pad in the center of the room. It looks like a rocket was once here but someone has taken it apart and hidden the pieces. There are exits to the North, South, and West.

You can see the launch pad here.

>build rocket
Yes, that looks right!

Yes, that looks right!

    *** You click the rocket pieces together and escape! But maybe you should have remembered the extra fuel... ***

In that game you scored 30 out of a possible 50, in 9 turns.

Would you like to RESTART, RESTORE a saved game, QUIT or UNDO the last command?

* * *

>take all
nose cone: Taken.

>wear nose cone
You can't wear that!

* * *

>w
control room
You can see a big television here.

>take nose cone
Taken.

>put on nose cone
You found an Easter egg, well done!

You put on the nose cone.

[Your score has just gone up by ten points.]

>e
Rocket base
The Rocket base is a big, circular room. There is a launch pad in the centre of the room. It looks like a rocket was once here but someone has taken it apart and hidden the pieces. There are exits to the North, South and West.

You can see launch pad here.

>put nose cone on launch pad
(first taking it off)
yes, that looks right!

[Your score has just gone up by ten points.]

* * *

>put on nose cone
You found an Easter egg, well done!

You put on the nose cone.

[Your score has just gone up by ten points.]

>put on nose cone
You're already wearing that!

>take off nose cone
You take off the nose cone.

>put on nose cone
You put on the nose cone.

>w
You can't go that way.

>climb shelf
You climb up the shelf and discover Easter egg 2!

[Your score has just gone up by ten points.]

>climb shelf
You climb up the shelf and discover Easter egg 2!

[Your score has just gone up by ten points.]

* * *

>take nose cone
Taken.

>wear nose cone
You found an Easter egg, well done!

You put on the nose cone.

[Your score has just gone up by ten points.]

>wear nose cone
You're already wearing that!

>take off nose cone
You take off the nose cone.

* * *

>put on nose cone
You put on the nose cone.

>climb shelf
You climb up the shelf and discover Easter egg 2!
You found another Easter egg while climbing the shelf!

Little is to be achieved by that.

[Your score has just gone up by ten points.]

>climb shelf
You already looked and there is nothing interesting there.

Little is to be achieved by that.

* * *

Video Game Menace
An Interactive Fiction by Martin Brown
Release 1 / Serial number 240316 / Inform 7 v10.1.2 / D

Rocket base
The Rocket base is a big, circular room. There is a launch pad in the center of the room. It looks like a rocket was once here but someone has taken it apart and hidden the pieces. There are exits to the North, South, and West.

You can see the launch pad here.

>west
storage cupboard
A small room used for storing things. There is a shelf against one wall.

A nose cone of a rocket.

You can see a shelf here.

>north
You can't go that way.